"filename", "language", "XML", "Markdown", "CUDA C++", "C++", "comment", "blank", "total"
"/home/mark/code/sdf_package_testing/src/gpu_voxels_ros/README.md", "Markdown", 0, 1, 0, 0, 0, 1, 2
"/home/mark/code/sdf_package_testing/src/gpu_voxels_ros/include/gpu_voxels_ros/composite_sdf_test.h", "CUDA C++", 0, 0, 87, 0, 20, 36, 143
"/home/mark/code/sdf_package_testing/src/gpu_voxels_ros/include/gpu_voxels_ros/gpu_voxels_hsr_server.h", "CUDA C++", 0, 0, 92, 0, 20, 36, 148
"/home/mark/code/sdf_package_testing/src/gpu_voxels_ros/include/gpu_voxels_ros/gpu_voxels_server.h", "CUDA C++", 0, 0, 53, 0, 19, 25, 97
"/home/mark/code/sdf_package_testing/src/gpu_voxels_ros/include/gpu_voxels_ros/gpu_voxels_signed_server.h", "CUDA C++", 0, 0, 58, 0, 21, 26, 105
"/home/mark/code/sdf_package_testing/src/gpu_voxels_ros/include/gpu_voxels_ros/timing.h", "CUDA C++", 0, 0, 144, 0, 24, 68, 236
"/home/mark/code/sdf_package_testing/src/gpu_voxels_ros/package.xml", "XML", 28, 0, 0, 0, 0, 8, 36
"/home/mark/code/sdf_package_testing/src/gpu_voxels_ros/src/DistanceROSDemo.cpp", "C++", 0, 0, 0, 188, 75, 74, 337
"/home/mark/code/sdf_package_testing/src/gpu_voxels_ros/src/composite_sdf_test.cpp", "C++", 0, 0, 0, 660, 174, 247, 1081
"/home/mark/code/sdf_package_testing/src/gpu_voxels_ros/src/composite_sdf_test_node.cpp", "C++", 0, 0, 0, 22, 1, 10, 33
"/home/mark/code/sdf_package_testing/src/gpu_voxels_ros/src/cow_and_lady_testing/signed_test_node.cpp", "C++", 0, 0, 0, 23, 0, 9, 32
"/home/mark/code/sdf_package_testing/src/gpu_voxels_ros/src/cow_and_lady_testing/unsigned_test_node.cpp", "C++", 0, 0, 0, 23, 0, 9, 32
"/home/mark/code/sdf_package_testing/src/gpu_voxels_ros/src/gpu_voxels.cpp", "C++", 0, 0, 0, 0, 180, 58, 238
"/home/mark/code/sdf_package_testing/src/gpu_voxels_ros/src/gpu_voxels_hsr_server.cpp", "C++", 0, 0, 0, 720, 179, 265, 1164
"/home/mark/code/sdf_package_testing/src/gpu_voxels_ros/src/gpu_voxels_server.cpp", "C++", 0, 0, 0, 118, 27, 62, 207
"/home/mark/code/sdf_package_testing/src/gpu_voxels_ros/src/gpu_voxels_server_node.cpp", "C++", 0, 0, 0, 22, 4, 10, 36
"/home/mark/code/sdf_package_testing/src/gpu_voxels_ros/src/gpu_voxels_signed_server.cpp", "C++", 0, 0, 0, 157, 33, 68, 258
"/home/mark/code/sdf_package_testing/src/gpu_voxels_ros/src/gpu_voxels_signed_server_node.cpp", "C++", 0, 0, 0, 27, 2, 11, 40
"/home/mark/code/sdf_package_testing/src/gpu_voxels_ros/src/load_cow_and_lady_ptcloud.cpp", "C++", 0, 0, 0, 85, 13, 32, 130
"/home/mark/code/sdf_package_testing/src/gpu_voxels_ros/src/raycasting_example.cpp", "C++", 0, 0, 0, 159, 101, 69, 329
"/home/mark/code/sdf_package_testing/src/gpu_voxels_ros/src/sdf_test.cpp", "C++", 0, 0, 0, 81, 32, 31, 144
"/home/mark/code/sdf_package_testing/src/gpu_voxels_ros/src/timing.cc", "C++", 0, 0, 0, 160, 27, 32, 219
"Total", "-", 28, 1, 434, 2445, 952, 1187, 5047